Width 40
Height 22
0000000000000000000000000000000000000000
0000000000000000000000000000000000000000
0040000000090000000000000000000000000000
0040700000030000000000000000000000000000
0040000000030000000001111114444400000300
0000000000000000000000000000000000000300
0000003000000000111000000000000000000300
0000003000000000000000000000000030000000
0000000000000000000000000000000030000000
0000000000001110000000000000000030900000
0000000000000000000000000000000030000300
0000000000000000000000000009000000000300
0000000000000000000000000000000000000300
0000000000000000000000000000000000000300
0000000000000000002222200000222230000000
0000000000000000000000000000000000000000
0000000000001110000000000000000000000000
0000000000000000000000000000000000000000
0000001110000000000000000000000000000000
0000000000000000000000000000000000000000
0000000000000000000000000000000000000000
1111111111111111000000000000000000000000
