Width 40
Height 26
0000000000000000000000000000000000000000
0000000000000000000000000000000000000000
0000000000000000000000000000000000000000
0000000000000000000000000000000000000000
0000000000000000000000000000000000000000
0000000000000000000000000000000000000000
0000000000090000000000000000000000000000
0000400000030000000000000000000000000000
0000407000030000000001111114444400003000
0000400000030000000000000000000000003000
0000000030000000111000000000000000003000
0000000030000000000000000000000003000000
0000000000000000000000000000000003000000
0000000000001110000000000000000003900000
0000000000000000000000000000000003000300
0000000000000000000000000009000000000300
0000000000000000000000000000000000000300
0000000000000000000000800000000000000300
0000000000000000002222200000222220000000
0000000000000000000000000000000000000000
0000000000001110000000000000000000000000
0000000000000000000000000000000000000000
0050001110000000000000000000000000000000
0000000000000000000000000000000000000000
0000000000000000000000000000000000000000
1111111111111111000000000000000000000000
