Width 40
Height 30
1111111111111111111111111111111111111111
1000000000000000000000000000000000000001
1000700000000000000000000000000000000001
1000000000090000090000900090000009000001
1111111111111111111111111111111111000001
1000000000000000000000000000000010000091
1000000000000000000000000000000010000011
1111111111111130093100000000000010000001
1000000000000030003100000000000019000001
1000000000000039003100000000000011000001
1000000000000030003100000000000010000091
4444444444444430093100000000000010000011
4000000000000030003100000000000010000001
4000000000000039003100000000000019000001
4000000000000000003100000000000011000001
4000090000000900003100000000000010000001
4004444444444444444100000000000010000091
4004000000000000000100000000000010000011
4004000000000000000100000000000010000001
4004000000000000000100000000000019000001
4004000000000000000100000000000011000001
4004000000000000000100000000000010000091
4004000000000000000100000000000000000011
4904000000000000000100000000000000000001
4004000000000000000111111111111111111111
4004000000000000000000000000000000000001
4094000000000000000000000000000000000001
4000000500000000000000000000000000000001
4000000000000000000000000000000000000001
1111111111111111111111111111111111111111
