Width 40
Height 26
0000000000000000000000000000000000000000
0000000000000000000000000000000000000000
0000000000000000000000000000000000000004
0000000000000000000000000000000000000004
0000000000000000000000000000000000000004
0070000000000000000000000000000000000004
0000090000000009000090000000000090008004
1111111110000222222222200000002222224004
0000000000000000000000000000000000004004
0000000000000000000000000000000000004094
0000000000000009000000000000000000000004
0000000000000011100000000009000000090004
0000000080000000000000000011100001111111
4444400111110000000009000000000000000000
4444400000000000000011100000000000000000
4444490000000000000000000000000000000000
4444400000000000000000000000000000000000
4444400800000090000009000000090000000090
1111111110000111000011100000111000000111
0000000000000000000000000000000000001111
0000000000000000000000000000000000001111
0000000000000000000000000000000000111111
0500000000000000000000000000000080111111
0000000000900000009000000090000011111111
1111100011111000111110001111100011111111
