Width 40
Height 30
0000000000000000000000000000000000000000
0000000000000000000000000000000000000000
0000000000000000000000000000000000000000
0000000000000000000000000000000000004000
0000000000000000000000000000000000004000
0000000000000000000000000000000000004000
0000000000000000000000000000000000004000
0000000000000000000000000000004000000000
0000000000000000000000000000004000000000
0000000000000000000000000000004000004000
0000000000000000000000000000004000004000
0000000000000000000000000000004000004000
0000000000000000000000000000000000004000
0000000000000000000000000000000000004000
0000000000000000000000008000000000000000
0000000000000000000300022222222000000000
0000000000000000000300000000000000000000
0000000000000000000300000000000000000000
0000000000000000000300000000000000000000
0000000000000000000300022222220000000000
0000000000011000000300000000000000000004
0000000000000000000300000000000000000004
0000000000000000300300000000000000000004
0000000000000000300300000000000000000004
4000011110000000300300000000000000000004
4000000000000000300300000000000000000000
4000000000000000300000000000002222222000
4000500000000000300000000000000000000000
4000000000000000000000800000000000000000
1111110000000000000222222200000000000000
