Width 40
Height 20
0000000000000000000000000000000000000000
1111111111111111111000000000000000000000
3000000000000000003000000000000000000000
3000000000000000003000000000000000000000
3000002222222220903000000000000000000000
3000003000000000003000000000000000000000
3009003000000000003000000000000000000000
3000003001111111111111111000000000000000
3000003000000000000000001000000000000000
3000003000000000000000001000000000000000
3000003001111111111111111444444444444444
4000000000000000000000000000000000000004
4000000000000000000000000000000000000004
2222222222222222222222222222220000222222
0000000000001000000000000000010000000001
1000110000001000000100000000011111100001
1000000000001000000000000000000000000001
1000000000001000010000000000000000000001
1000000000001000000000000000011111100001
1111000000000001000000000000000000144441
