0000000000
0000000000
0111001110
0000110000
0000000000
0000000000
0000000000
0000000000
0000000000
1111001111