0000000000
0000000100
0000000100
0000000100
0000000100
0000000100
0000000100
0000000000
0000000000
1110000001