Width 25
Height 20
0000000000000000000000000
0000000000000000000000000
0000000000000000000000000
0000000000000000000000000
0400000000000000000000000
3110010000000900000000000
3113030000300030000000000
3111330000300030000000000
3111130000300030000000000
3111130090300030000000000
3111111111111111111111111
1100000000001000000000000
1100110000001000000000000
1110000000001000010000000
0000000000001000000000000
1000110000001000000100000
1000000000001000000000000
1000000000001000010000000
1000000000001000000000000
1111000000000001000000000
