0000000000
0000000000
0000000000
0000000000
0000000000
0000000000
0000000000
0101010101
0000000000
1111111111