1010101010
1000000000
0000000000
1000100000
0010000110
1000111100
0000000000
1000000000
0000000000
1111100000