Width 20
Height 20
00000000000000000000
00000000000000000000
00000000000000000000
00000000000000000000
00000000000000000000
31100000000009000000
31130000000000000000
31113000009000900000
31111300900000900000
31111130900000900000
31111111111111111122
11000000000010000000
11001100000010000000
11100000000010000100
00000000000010000000
10001100000010000001
10000000000010000000
10000001100010000100
10000000000010000000
11110222211110010000
