Width 40
Height 20
0000000000000000000000000000000000000000
0000000000000000000000000000000000000000
0000000000000000000000000000000000000000
0000000000000000000000000000000000000000
0000000000000000000000000000000000000000
3000000000000900000000000000000000000000
3000003000000000000000000000000000000000
3000003000000000000000000000000000000000
3000003000000000000000080000000000000000
3000003090000000000000000000000000000008
3000003003333333111111111444444444444444
4000000000000000000000000000000000000000
4000000000000000000000000000000000000000
2222222222222222222222222222222222222222
0000000000001000000000000000000000000000
1000110000001000000100000000000000000000
1000000000001000000000000000000000000000
1000000000001000010000000000000000000000
1000000000001000000000000000000000000000
1111000000000001000000000000000000000000
