Width 40
Height 20
1111111111111111111111111111111111111111
1000000000000000000800000000000000000004
1000000000000000000000000000000000000004
3111111111111111111111111111111111114004
3000000000000000000000000000000000004004
3000000000000000000000000000000000000004
3000003222222222222222222222222222222221
3000003000000000000000000000000000000001
3000003000000000000000000000000000000001
3000003000000000000000000000000000000001
3000003111111111111111111111111111111001
4000003000000000000000000000000000001001
4000000000000000000000000000000000001001
1222222022222222202220022220222223001001
1000000000000000000000000000000003003001
1000000000000000000000000000000003003001
1000000000000000000000000000000000003001
3003333333333333333333333333333333333001
1000000000000000000000000000000000000001
1222222222222222222222222222222222222221
