00000000000000000000
00000000000000000000
00000000000000000000
00000000000000000000
00000000000000000000
00000000000000000000
00000000000000000000
00000000000000000000
00000001111110000000
10000001000010000000
10001101111010010000
11000000000010000000
11001100000010000000
11100000000010000100
00000000000010000000
10001100000010000001
10000000000010000000
10000001100010000100
10000000000010000000
11110111111110010000