Width 40
Height 20
0000000000000000000000000000000000000000
0000000000000000000000000000000000000000
0000000000000000000000000000000000000000
0000000000000000000000000000000000000000
0000000000000000000000000000000000000000
3110010000000900000000000000000000000000
3113013000000000000000000000000000000000
3111313000000000000000000000000000000000
3111113000000000000000000000000000000000
3111113090000000000000000000000008000008
3111113003333333111111111444444444444444
0000000000000000000000000000000000000000
0000000000000000000000000000000000000000
2222222222222222222222222222222222222222
0000000000001000000000000000000000000000
1000110000001000000100000000000000000000
1000000000001000000000000000000000000000
1000000000001000010000000000000000000000
1000000000001000000000000000000000000000
1111000000000001000000000000000000000000
