Width 20
Height 20
00000000000000000000
00000000000000000000
00000000000000000000
00000000000000000000
04000000000000000000
31100300000009000000
31130300000000300000
31113300009000300000
31111300000000300000
31111100900000100000
31112222222222222222
11000000000010000000
11001100000010000000
11100000000010000100
00000000000010000000
10001100000010000001
10000000000010000000
10000000000010000100
10000000000010000000
11110000000000010000
